##############
#\\... ......#
###.#. ...*..#
  #.#. ... ..#
### #.   \ ..#
#. .#..... **#######
#.#\#..... ..\\\*. #
#*\\#.###. ####\\\ #
#\\.#.     ...## \ #
#\#.#..... ....# \ #
###.#..... ....#   ##
#\\.#..... ....#\   #
########.. ..###*####
#......... .........#
#......... ....***..#
#..\\\\\ # ####.....#
#........*R..\\\   .#
##########L##########
